11340512345123451234
19000000000000000001
10458111161130405011
20000300000040512034
51230405723450100002
30000405010000203405
10230405010234501002
30040000050000001023
45012345012340512003
40050001020000304512
30450102034510200003
40000501020000304501
23451203040512304005
10200003040050001023
40005012034050123004
50123040000050102304
50100023451230400005
10234510200030405123
40000000005000100002
34512345123451230451
