11340512345123451234
19000000000000000000
10458111111130405011
20000300000040502034
51230405623450100002
30000405010000203405
10230405010234501002
30040000050000001023
45012345012340502003
40050001020000304512
30450102034510200003
40000501020000304501
23451203040512304005
10200003040050001023
40005012034050103004
50123040000050102304
50100023451230400005
10234510200030405123
40000000005000100002
34512345123451230451
